####################
#                  #
#                  #
#             M    #
#                  #
#                  #
#                  #
#                  #
#             M    #
#                  #
#                  #
#              M   #
#                  #
#                  #
#    M             #
#                  #
#                  #
#                  #
#        H         #
####################