         ###
         #E#
         #.#
         #.#
         #.#
      ####.#
      #S...#
      #.####
      #.###
      #...#
      ###.#
        #.#
        #.#
      ###.###
      #.....#
      #.#.#.#
      #.#.#.#
      #..S#.#
   ########.#
   #....# #.#
   #.##.###.#
   #.##.....#
####.############
#.........##S...#
#.  .####....  .#
#.  .#  #####  .#
#....#   #  H  .#
######   #     .#
         #     .#
         ########