    ###
    #E#
    #.#
#####.#########
W.....#       W
W.       #    W
W. #......    W
W.  .##  .    W
W.  .#....#   W
#S...#.       W
W   T#.    #  W
W    #......  W
W          .  W
W       #  .  W
#WW     ....T W
  W  #  .  .  W
  W  ....# .  W
  W  .  S  S  W
  W  .  .# #  W
  W #.....    W
  #######.#####
        #.###
#####   #...#
#...#######.###
#.#.....#.....#
#.#####.#.T.#.#
#.....#.#...#.#
#     #.#####.#
#     #.......#
#  H  #########
#######
