                  ###
#######           #E#
#....S########    #.#
#.     ......# ####.#
#.     #####.###....####
##  H  #  ##...#.......#
 #######  #....#.  #  .W
          #....#......SW
          #...##....####
          #...#####.##
          ###.#####..#
           #..##.....#
           #S....#####
           W.. .##
           W.. .#
           W....#
           ######