        #############
        #...........#
        #          .#
        #     WWWWW.#
        #  H  #  ##.#
        #######  #..#
                 #.##
              #WWW.#
              #   .#
              #S...#
              #.####
             ##.#
  ############..#
###....##...##.#####
#  .  .##.#.##.....#
#...S#....#.....##.#
#.#############.  .#
#.#           W.  .#
#.#           W...S#
#E#           ######
###
