 ###
 #E#
 #.# #######
 #.# #.....#
 #.###.###.#
 #.   .# #.#
 #..S..# #.###
 ####### #...#
         ## .#
  ##TTT## # .#
 ##.....### .#
 #..###.##...#
 #.## #.  .###
 #..###....#
###...######
#S....#
#.    #
#.    #
#. T  #
#...  #
###.######  ########
  #.#....#  #......#
  #.#.. .TTTT.     #
  #...S#......     #
  ####. .#####     #
     #...#   #  H  #
     #####   #######