###
#E#
#.#
#.#
#.######
#......#####WWW#
######.#....   W
  #....#.##.   W
  #.TS...##.   ###
  #.  ##.##.#...S##
  #. #...##...#...#
  #....##########.#
  #########.....#.#
     #....#.###.#.#
     T.##.#.###.#.#
     T.##.....#...#
     T.####.#.#####
     #......#.....#
     ##TTT###S###.#
         #......#.#
         #.##T#.#.#
         #..# #...#
         ##.#######
          #.......#
          #.      #
          #.      #
          ##   H  #
           ########